9
9
 #####   
 #   ####
 #   #  #
 ##    o#
### ###o#
# @ ###o#
# @@#####
#A  #####
#####    