9
9
 #####   
 #   ####
 # @ #  #
 ##A   o#
### ###o#
# @ ###o#
# @ #####
#   #####
#####    
medium1